1 1 1 1 1 1 1 1 1 1 1 1 1 1 1 1 1 1 1 1 1 1 1 1 1 
1 0 0 0 0 0 0 0 0 0 0 0 0 0 0 0 0 0 0 0 0 0 0 0 1 
1 0 2 2 2 2 2 2 2 1 2 2 1 2 2 1 2 2 2 2 2 2 2 0 1 
1 0 2 2 2 2 2 2 2 2 2 2 2 2 2 2 2 2 2 2 2 2 2 0 1 
1 0 2 2 2 2 2 2 2 1 2 2 1 2 2 1 2 2 2 2 2 2 2 0 1 
1 0 2 2 2 2 2 2 2 2 2 2 2 2 2 2 2 2 2 2 2 2 2 0 1 
1 0 2 2 2 2 2 2 2 1 2 2 1 2 2 1 2 2 2 2 2 2 2 0 1 
1 0 2 2 2 2 2 0 0 0 0 0 0 0 0 0 0 2 2 2 2 2 2 0 1 
1 0 2 2 2 2 2 0 0 1 0 0 1 0 0 1 0 2 2 2 2 2 2 0 1 
1 0 2 1 2 2 1 0 0 1 0 0 1 0 0 1 0 2 1 2 2 1 2 0 1 
1 0 2 2 2 2 2 0 0 1 0 0 1 0 0 1 0 2 2 2 2 2 2 0 1 
1 0 2 2 2 2 2 0 0 0 0 0 0 0 0 0 0 2 2 2 2 2 2 0 1 
1 0 1 2 1 2 1 0 1 1 1 0 1 0 1 1 1 2 1 2 1 2 1 0 1 
1 0 2 2 2 2 2 0 0 0 0 0 0 0 0 0 0 2 2 2 2 2 2 0 1 
1 0 2 2 2 2 2 0 0 1 0 0 1 0 0 1 0 2 2 2 2 2 2 0 1 
1 0 2 1 2 2 1 0 0 1 0 0 1 0 0 1 0 2 1 2 2 1 2 0 1 
1 0 2 2 2 2 2 0 0 1 0 0 1 0 0 1 0 2 2 2 2 2 2 0 1 
1 0 2 2 2 2 2 2 2 2 2 2 2 2 2 2 2 2 2 2 2 2 2 0 1 
1 0 2 2 2 2 2 2 2 1 2 2 1 2 2 1 2 2 2 2 2 2 2 0 1 
1 0 2 2 2 2 2 2 2 2 2 2 2 2 2 2 2 2 2 2 2 2 2 0 1 
1 0 2 2 2 2 2 2 2 1 2 2 1 2 2 1 2 2 2 2 2 2 2 0 1 
1 0 2 2 2 2 2 2 2 2 2 2 2 2 2 2 2 2 2 2 2 2 2 0 1 
1 0 2 2 2 2 2 2 2 1 2 2 1 2 2 1 2 2 2 2 2 2 2 0 1 
1 0 0 0 0 0 0 0 0 0 0 0 0 0 0 0 0 0 0 0 0 0 0 0 1 
1 1 1 1 1 1 1 1 1 1 1 1 1 1 1 1 1 1 1 1 1 1 1 1 1 
309 23 23 1 1 2 4 5 3 20 3 5 20 20 20 2 5 3 20 20 